111111111111111
1000000000000P1
100000000000001
1000C0000000001
10000000000E00E
111111111111111
