11111111111111111111111111111111111111111111111111111111
110010000001101000000C000C00000000000C0000000000C00C0001
100C001010000010C000000001011000100110000010000001000101
10000000100000011000000000010C1000C001CC0000000100000001
1C00100100000010001C000001000000010000011100000000000001
1001C000C000001000000010C1C000001C0110C000100P000CC00001
100C00100010001001000110000000000101000C01000000C1010001
100010000000000000C0000010110000000000000C00101000000001
1000000000110001C001000100110CC1000000000C00001010000111
1C0C0001C1E000000000100110011000110000101001001100C00001
10CC000001000010C000110C0C0C00000000010000000000000C0011
11010000000000C000000000000C1110001011000000C00000001001
100000000010101110000C00000001100000000001100010000C1001
101010110100000000C01C000000C0C0000000000011000010000011
10100C0000000001000101C0000000100000000C0000C0100001C001
10100010001000C1100100000000010100000000010C000000000011
1C1000001000000100000011CC000010010000010000000000000111
1100100C0001000000010000000000000010001110C0100000000001
1000000001100000000000000000100001100000000000C000000C01
10000101000C00100000C000000C0001000001000CC0000000C01001
1101100010001000000010C00C00000000C000110000101000000001
10000110000011C100C0010101100000000010000000000001000101
1110001C00CC1000000C000C00000000000000011000C0C000000101
10000100C000001000C0000000001000100010000000000000000001
100100000011100000011000000000000C000000001100C101C00011
100000010001100000001011C01C000010010C0010010100C0000001
1000001C00000000000000C0000101010000100C0000001000000001
1C00000000000C0C100100001C0100011000C1101000000110100001
10010000100001000000000010001001000000000001001001C00101
11111111111111111111111111111111111111111111111111111111
