111111111111111111111111111111111111111111
100110001C0000000000000000000000000CC10101
100000C000000C0C0C00000000C010C00000000001
100000000001000001000C00000010000000000001
1000000100000C000000000C00100C010000010001
10000000000000C0000C000000000C000011000001
1000001000100000100010CC000000C00000000001
10000000000000000000000000000000C000000001
100000000000001000010C000000000000C0000001
10000000000C0000000010000100000000000C0001
1C0000C00001000000000C00000000000000000001
100000000C000010001000000010000000000C0001
100000001C000000000000C0000001110010000001
100000000000000C00C00010C00000100000000001
1100100000000000000000000000000C000C0000C1
100C0C00000100C000010000000000000000000001
10000000000000C000000000C10001C000000000C1
10C000000C000001C00000000000000C00000C00E1
110P00C000C11000000000000001C0000000000001
1C000C0010C0C0000000000000000001C000000001
100C0000C00000000C00C00C000000C00C00000001
100000000CC00C00000000000001000000C0000001
100000000000001C000000000100000C0000000001
111111111111111111111111111111111111111111
