1111111111111111111111111
1100010000000010000100001
1C010000000001000000C0001
10C001C0000C00C0010010001
10001000010010C0000000001
10000100C00C000010000C001
10001110000100101C0100111
10000010000001000C1011001
110100000011C000000100001
10000000010000000111010C1
10001000000010000C0000C01
100001000000CC0000C0C0001
100011P0100000C0000001101
110C100001000001000000001
1000101000100100010110001
10000C01C00C1010000101001
111000000000C010C1C0010C1
1100101010010100000110001
1000000C100000010CC000001
101000000000000000CC01011
1000010000000100001000001
10001000000C0000001000001
1010000010001001010010001
10000001C0C000101000C1001
1000100100000000110000001
110100010000110000001C001
100C001C0000000001C000101
11001C010100001000E000001
1000000001000000000010001
1000C00000C00010000C00001
1111111111111111111111111
