111111111111111
1000000000000P1
100000000000001
1000C00000000011
10000000000E001
111111111111111
