111111111111111
1000000000100P1
100000000010001
1000C0000011111
10000000000E001
111111111111111
