11111111111111111111111111111111111111111111111111111111
1E0000000000000C00000C0000000000000000000C00000C00000001
10100101001000001010010000000101010010010100100000101001
10100100101010100010010000000101010010010010101010100001
1P0000000C00C000000000000000000000000C00C000000000000001
11111111111111111111111111111111111111111111111111111111
