111111111111111111111111111111111111111111111111111111111
1000000000C01000010C00000010110C00001000000C0000000010011
1000000C0000011000000100C000000001C1000000000000000000001
1101C0010100000C0C10000000000C000000C00010000010C01000001
100000001001C01010000100100000100010100000000000011000011
10000001100010010000C0C0010000000001000000000C00010000101
10101000000000000C0000000000000000000000000C0000000100101
11000000000011000C00000010000010101000C010100010000101C11
110000000CC1000010000000010000001000001010100010000C00CC1
10100000100100100000000000010000C0000C0000000000000100001
101000000000000001000000C0111000100C0C0C101010CC000000001
100000000010011C000000000000000000CCC010001C10110C0001001
1110010010C0001110100C00000000000C001100000110000011C1001
101000000000000000000000000000100001001000100000000CC0001
100000C000010001010001010000000000000011C1000000000100101
1100C0C1000001000000000000000000CCCC100100000000000000001
1100CC101000001111C000010100001001000C00000000000C0000001
1100000110000100001000100000000000000C0000000001000001C01
1010000000001000000100010000001C0000100000001100000000001
10100000100C100101001000C10100100110000000000000000000001
10000001000001010010100000000000C001001000010001000011001
1000000101111000000000C0100010000000100011000000000100011
100000CCE01000C0000000100000C0010000C010101C0000000000101
1100P000101000010C01010C000001110010C100010C01010100100C1
10100010011001C0001000000000000000000010100C0000000000101
10000000000000110000C1000100000000001101C1000C0010C001101
10C010000C00C0001001C0010000000010000C0000000C0000C000101
10000011100100100100001C01001010010C000010000000000000001
100000000000C0010C100000C0CC000C0100C00100011000C00C11001
111111111111111111111111111111111111111111111111111111111
