111111111101111
1000000000000P1
100000000000001
1000C0000000001
10000000000E001
111111111111111
